                                                                                
                                                                                
                                                                                
                                                                                
                                                                                
                                                                                
                                                                                
                                                                                
                                                                                
                                                                                
                                                                                
                                                                                
                                                                                
                                                                                
                                                                                
                                                                                
                                                                                
                                                                                
                                                                                
                                           @@@@@@@@@@@@@@@@@@@@@@@@@@@@@@@@@@,  
                                           @@@@@@@@@@@@@@@@@@@@@@@@@@@@@@@@@@,  
                                           @@@@@@                        @@@@,  
                                           @@@@@@                        @@@@,  
                                           @@@@@@@@@@@@@@@@@@@@@@@@@@@@@@@@@@,  
                                           @@@@@@@@@@@@@@@@@@@@@@@@@@@@@@@@@@,  
                                                                @@@@@@@@@@@@@,  
                                                                @@@@@@@@@@@@@,  
                                                                @@@@@@@@@@@@@,  
                                                                @@@@@@@@@@@@@,  
 ####################                                           @@@@@@@@@@@@@,  
 @@@@@@@@@@@@@@@@@@@@                                           @@@@@@@@@@@@@,  
 @@              @@@@   @@@@@@@@@@@@@@@@@@@@@@@@@@@@@@@@@@@@@@(    @@           
 @@              @@@@   @@@@@@@@@@@@@@@@@@@@@@@@@@@@@@@@@@@@@@(    @@           
 @@@@@@@@@@@@@@@@@@@@   @@@@@@@@@@@@@@@@@@@@@@@@@@@@@@@@@@@@@@(    @@           
 @@@@@@@@@@@@@@@@@@@@   @@@@@@                          @@@@@@(    @@           
 @@@@@@@@@@@@@@@@@@@@   @@@@@@                          @@@@@@(    @@           
       @                @@@@@@@@@@@@@@@@@@@@@@@@@@@@@@@@@@@@@@(    @@           
       @                                         &@@               @@           
       @                                             %@@           @@           
       @                                                 (@@       @@           
       @                                               @@@@@@@@@@@@@@@@@@@@@@@@ 
@@@@@@@@@@@@@@@@@@@@@@@@                               @@@@@@@@@@@@@@@@@@@@@@@@ 
@@@@@@@@@@@@@@@@@@@@@@@@                               @@@@@@@@@@@@@@@@@@@@@@@@ 
@@@@               @@@@@                               @@@@@@@@@@@@@@@@@@@@@@@@ 
@@@@               @@@@@                               @@@                 @@@@ 
@@@@@@@@@@@@@@@@@@@@@@@@                               @@@@@@@@@@@@@@@@@@@@@@@@ 
@@@@@@@@@@@@@@@@@@@@@@@@                               @@@@@@@@@@@@@@@@@@@@@@@@ 
@@@@@@@@@@@@@@@@@@@@@@@@                               @@@@@@@@@@@@@@@@@@@@@@@@ 
                @@                    @                      @@                 
                  (@                  @                   @@                    
                     @#              %@                @@                       
                       @@        %&@@@@%            @@                          
                         @@@@@@@@@@@@@@@@@@@@@@@ @@                             
                     &@@@@@@@@@@@@@@@@@@@@@@@@@@@@@@                            
                   @@@@@@@@@@@@@@@@@@@@@@@@@@@@@@@@@@@                          
                  @@@@@@@@@@@@@@@@@@@@@@@@@@@@@@@@@@@@@                         
                  @@@@@@@@@@@@@@@@@@@@@@@@@@@@@@@@@@@@@                         
