                    
                                                                                
                @@                    @                      @@                 
                  (@                  @                   @@                    
                     @#              %@                @@                       
                       @@        %&@@@@%            @@                          
                         @@@@@@@@@@@@@@@@@@@@@@@ @@                             
                     &@@@@@@@@@@@@@@@@@@@@@@@@@@@@@@                            
                   @@@@@@@@@@@@@@@@@@@@@@@@@@@@@@@@@@@                          
                  @@@@@@@@@@@@@@@@@@@@@@@@@@@@@@@@@@@@@                         
                  @@@@@@@@@@@@@@@@@@@@@@@@@@@@@@@@@@@@@                         
