                                                                                
                                                                                
                                                                                
                                                                                
                                                                                
                                                                                
                                                                                
                                                                                
                                                                                
                                                                                
                                                                                
                                                                                
                                                                                
                                                                                
                                                                                
                                                                                
                                                                                
                                                                                
                                                                                
                                           @@@@@@@@@@@@@@@@@@@@@@@@@@@@@@@@@@,  
                                           @@@@@@@@@@@@@@@@@@@@@@@@@@@@@@@@@@,  
                                           @@@@@@                        @@@@,  
                                           @@@@@@                        @@@@,  
                                           @@@@@@@@@@@@@@@@@@@@@@@@@@@@@@@@@@,  
                                           @@@@@@@@@@@@@@@@@@@@@@@@@@@@@@@@@@,  
                                                                @@@@@@@@@@@@@,  
                                                                @@@@@@@@@@@@@,  
                                                                @@@@@@@@@@@@@,  
                                                                @@@@@@@@@@@@@,  
 ####################                                           @@@@@@@@@@@@@,  
 @@@@@@@@@@@@@@@@@@@@                                           @@@@@@@@@@@@@,  
 @@              @@@@                                              @@           
 @@              @@@@                                              @@           
 @@@@@@@@@@@@@@@@@@@@                                              @@           
 @@@@@@@@@@@@@@@@@@@@                                              @@           
 @@@@@@@@@@@@@@@@@@@@                                              @@           
       @                                                           @@           
       @                                                           @@           
       @                                                           @@           
       @                                                           @@           
       @                                               @@@@@@@@@@@@@@@@@@@@@@@@ 
@@@@@@@@@@@@@@@@@@@@@@@@                               @@@@@@@@@@@@@@@@@@@@@@@@ 
@@@@@@@@@@@@@@@@@@@@@@@@                               @@@@@@@@@@@@@@@@@@@@@@@@ 
@@@@               @@@@@                               @@@@@@@@@@@@@@@@@@@@@@@@ 
@@@@               @@@@@                               @@@                 @@@@ 
@@@@@@@@@@@@@@@@@@@@@@@@                               @@@@@@@@@@@@@@@@@@@@@@@@ 
@@@@@@@@@@@@@@@@@@@@@@@@                               @@@@@@@@@@@@@@@@@@@@@@@@ 
@@@@@@@@@@@@@@@@@@@@@@@@                               @@@@@@@@@@@@@@@@@@@@@@@@ 
                @@                    @                      @@                 
                  (@                  @                   @@                    
                     @#              %@                @@                       
                       @@        %&@@@@%            @@                          
                         @@@@@@@@@@@@@@@@@@@@@@@ @@                             
                     &@@@@@@@@@@@@@@@@@@@@@@@@@@@@@@                            
                   @@@@@@@@@@@@@@@@@@@@@@@@@@@@@@@@@@@                          
                  @@@@@@@@@@@@@@@@@@@@@@@@@@@@@@@@@@@@@                         
                  @@@@@@@@@@@@@@@@@@@@@@@@@@@@@@@@@@@@@                         
