                                                                                
                                                                                
                                                                                
                                                                                
                                                                                
                                                                                
                                                                                
                                                                                
                                                                                
                                                                                
                                                                                
                                                                                
                                                                                
                                                                                
                                                                                
                                                                                
                                                                                
                                                                                
                                                                                
                                           @@@@@@@@@@@@@@@@@@@@@@@@@@@@@@@@@@,  
                                           @@@@@@@@@@@@@@@@@@@@@@@@@@@@@@@@@@,  
                                           @@@@@@                        @@@@,  
                                           @@@@@@                        @@@@,  
                                           @@@@@@@@@@@@@@@@@@@@@@@@@@@@@@@@@@,  
                                           @@@@@@@@@@@@@@@@@@@@@@@@@@@@@@@@@@,  
                                                                @@@@@@@@@@@@@,  
                                                                @@@@@@@@@@@@@,  
                                                                @@@@@@@@@@@@@,  
                                                                @@@@@@@@@@@@@,  
                                                                @@@@@@@@@@@@@,  
                                                                @@@@@@@@@@@@@,  
                        @@@@@@@@@@@@@@@@@@@@@@@@@@@@@@@@@@@@@@(    @@           
                        @@@@@@@@@@@@@@@@@@@@@@@@@@@@@@@@@@@@@@(    @@           
                        @@@@@@@@@@@@@@@@@@@@@@@@@@@@@@@@@@@@@@(    @@           
                        @@@@@@                          @@@@@@(    @@           
                        @@@@@@                          @@@@@@(    @@           
                        @@@@@@@@@@@@@@@@@@@@@@@@@@@@@@@@@@@@@@(    @@           
                                                 &@@               @@           
                                                     %@@           @@           
                                                         (@@       @@           
                                                       @@@@@@@@@@@@@@@@@@@@@@@@ 
                                                       @@@@@@@@@@@@@@@@@@@@@@@@ 
                                                       @@@@@@@@@@@@@@@@@@@@@@@@ 
                                                       @@@@@@@@@@@@@@@@@@@@@@@@ 
                                                       @@@                 @@@@ 
                                                       @@@@@@@@@@@@@@@@@@@@@@@@ 
                                                       @@@@@@@@@@@@@@@@@@@@@@@@ 
                                                       @@@@@@@@@@@@@@@@@@@@@@@@ 
                @@                    @                      @@                 
                  (@                  @                   @@                    
                     @#              %@                @@                       
                       @@        %&@@@@%            @@                          
                         @@@@@@@@@@@@@@@@@@@@@@@ @@                             
                     &@@@@@@@@@@@@@@@@@@@@@@@@@@@@@@                            
                   @@@@@@@@@@@@@@@@@@@@@@@@@@@@@@@@@@@                          
                  @@@@@@@@@@@@@@@@@@@@@@@@@@@@@@@@@@@@@                         
                  @@@@@@@@@@@@@@@@@@@@@@@@@@@@@@@@@@@@@                         
