                                                                                
                                                                                
                                                                                
                                                                                
                                                                                
                                                                                
                                                                                
                                                                                
                                                                                
                                                                                
                                                                                
                                                                                
                                                                                
                                                                                
                                                                                
                                                                                
                                                                                
                                                                                
                                                                                
                                           @@@@@@@@@@@@@@@@@@@@@@@@@@@@@@@@@@,  
  @@@@@@@@@@@@@@@@@@@@@@@@@@@@@@@@@        @@@@@@@@@@@@@@@@@@@@@@@@@@@@@@@@@@,  
  @@@                          @@@@        @@@@@@                        @@@@,  
  @@@                          @@@@        @@@@@@                        @@@@,  
  @@@@@@@@@@@@@@@@@@@@@@@@@@@@@@@@@        @@@@@@@@@@@@@@@@@@@@@@@@@@@@@@@@@@,  
  @@@@@@@@@@@@@@@@@@@@@@@@@@@@@@@@@        @@@@@@@@@@@@@@@@@@@@@@@@@@@@@@@@@@,  
  @@@@@@@@@@@@@@@@@@@@@@@@@@@@@@@@@                             @@@@@@@@@@@@@,  
                 @                                              @@@@@@@@@@@@@,  
                 @                                              @@@@@@@@@@@@@,  
                 @                                              @@@@@@@@@@@@@,  
 ################@###                                           @@@@@@@@@@@@@,  
 @@@@@@@@@@@@@@@@@@@@                                           @@@@@@@@@@@@@,  
 @@              @@@@   @@@@@@@@@@@@@@@@@@@@@@@@@@@@@@@@@@@@@@(    @@           
 @@              @@@@   @@@@@@@@@@@@@@@@@@@@@@@@@@@@@@@@@@@@@@(    @@           
 @@@@@@@@@@@@@@@@@@@@   @@@@@@@@@@@@@@@@@@@@@@@@@@@@@@@@@@@@@@(    @@           
 @@@@@@@@@@@@@@@@@@@@   @@@@@@                          @@@@@@(    @@           
 @@@@@@@@@@@@@@@@@@@@   @@@@@@                          @@@@@@(    @@           
       @                @@@@@@@@@@@@@@@@@@@@@@@@@@@@@@@@@@@@@@(    @@           
       @                                         &@@               @@           
       @                                             %@@           @@           
       @                                                 (@@       @@           
       @                                               @@@@@@@@@@@@@@@@@@@@@@@@ 
@@@@@@@@@@@@@@@@@@@@@@@@     @@@@@@@@@@@@@@@@@@@@@@@   @@@@@@@@@@@@@@@@@@@@@@@@ 
@@@@@@@@@@@@@@@@@@@@@@@@     @@@@@@@@@@@@@@@@@@@@@@@   @@@@@@@@@@@@@@@@@@@@@@@@ 
@@@@               @@@@@     @@@               @@@@@   @@@@@@@@@@@@@@@@@@@@@@@@ 
@@@@               @@@@@     @@@               @@@@@   @@@                 @@@@ 
@@@@@@@@@@@@@@@@@@@@@@@@     @@@@@@@@@@@@@@@@@@@@@@@   @@@@@@@@@@@@@@@@@@@@@@@@ 
@@@@@@@@@@@@@@@@@@@@@@@@     @@@@@@@@@@@@@@@@@@@@@@@   @@@@@@@@@@@@@@@@@@@@@@@@ 
@@@@@@@@@@@@@@@@@@@@@@@@     @@@@@@@@@@@@@@@@@@@@@@@   @@@@@@@@@@@@@@@@@@@@@@@@ 
                @@                    @                      @@                 
                  (@                  @                   @@                    
                     @#              %@                @@                       
                       @@        %&@@@@%            @@                          
                         @@@@@@@@@@@@@@@@@@@@@@@ @@                             
                     &@@@@@@@@@@@@@@@@@@@@@@@@@@@@@@                            
                   @@@@@@@@@@@@@@@@@@@@@@@@@@@@@@@@@@@                          
                  @@@@@@@@@@@@@@@@@@@@@@@@@@@@@@@@@@@@@                         
                  @@@@@@@@@@@@@@@@@@@@@@@@@@@@@@@@@@@@@                         
